eanáir	eanáir
eanair	eanáir
feabhra	feabhra
márta	márta
marta	márta
aibreán	aibreán
aibrean	aibreán
bealtaine	bealtaine
meitheamh	meitheamh
iúil	iúil
iuil	iúil
lúnasa	lúnasa
lunasa	lúnasa
meán	meán fómhair
mean	meán fómhair
meán fómhair	meán fómhair
mean fomhair	meán fómhair
deireadh fómhair	deireadh fómhair
deireadh	deireadh fómhair
deireadh fomhair	deireadh fómhair
deireadh fomhair	deireadh fomhair
samhain	samhain
nollaig	nollaig
