bliain	bhliain
bhliain	bhliain
bliana	bhliain
mbliana	bhliain
seachtain	seachtain
sheachtain	seachtain
seachtaine	seachtain
uair	uair
huaire	uair
n-uaire	uair
ceann	cheann
cinn	cheann
gcinn	cheann
cloigeann	chloigeann
chloigeann	chloigeann
cloigne	chloigeann
gcloigne	chloigeann
orlach	orlach
horlaí	orlach
n-orlaí	orlach
troigh	troigh
troithe	troigh
dtroithe	troigh
pingin	phingin
phingin	phingin
pingine	phingin
bpingine	phingin
scilling	scilling
scillinge	scilling
